Castle (Intro movie): Unreal
Vortex Rikers: Vortex2
NyLeve's Falls: NyLeve
Rrajigar Mine: Dig
Depths Of Rrajigar: Dug
Sacred Passage: Passage
Chizra - Nali Water God: Chizra
The Ceremonial Chambers: Ceremony
Dark Arena: Dark
Harobed Village: Harobed
Terraniux Underground: TerraLift
Terraniux: Terraniux
Noork's Elbow: Noork
Temple Of Vandora: Ruins
The Trench: Trench
ISV-KRAN deck 4: IsvKran4
ISV-KRAN decks 3 & 2: IsvKran32
ISVDECK1: IsvDeck1
Spire Village: SpireVillage
The Sunspire: TheSunspire
Gateway To Na Pali: SkyCaves
Na Pali Haven: SkyTown
Outpost 3J: SkyBase
Velora Pass: VeloraEnd
Bluff Eversmoking: Bluff
Dasa Mountain Pass: DasaPass
Cellars At Dasa Pass: DasaCellars
Serpent Canyon: NaliBoat
Nali Castle: NaliC
Demonlord's Lair: NaliLord
Demon Crater: DCrater
MotherShip Basement: ExtremeBeg
MotherShip Lab: ExtremeLab
MotherShip Core: ExtremeCore
Skaarj Generator: ExtremeGen
Illumination: ExtremeDGen
The Darkening: ExtremeDark
The Source Antechamber: ExtremeEnd
The Source: QueenEnd
Ending Sequence (movie): Endgame 